NO ./Include/assets/walls/Texturelabs_Brick_123S.png
SO ./Include/assets/walls/Texturelabs_Fabric_121S.png
WE ./Include/assets/walls/Texturelabs_Grunge_190S.png
EA ./Include/assets/walls/Texturelabs_Paper_278S.png


F 50,50,50
C 150,150,200

1111111111
1001001111
100W000001
1111111111