NO ./Include/assets/walls/street.png
SO ./Include/assets/walls/obito2.png
WE ./Include/assets/walls/street2.png
EA ./Include/assets/walls/obito4.png


F 50,50,50


11111111111111111111
10000000010000000001
10000000010000000000
10000100110000000001
10110000000000000001
100000000001110N0001
10000000100000000001
10000011110000000001
10000000001000000001
11111111111111111001