
EA ./Include/assets/walls/obito4.png


F 50,50,50
C 150,150,200

11111111111111111111
10000000010000000001
10000000010000000001
10000100110000000001
10110000000000000001
10000000000111000001
10000000100000000001
1000001111000N000001
10000000001000000001
11111111111111111111