NO ./Include/assets/walls/Texturelabs_InkPaint_306S.png
SO ./Include/assets/walls/Texturelabs_Fabric_121S.png
WE ./Include/assets/walls/Texturelabs_Grunge_190S.png
EA ./Include/assets/walls/Texturelabs_Paper_278S.png

F 220,100,0
C 225,30,0
1111111111111111111111111111111111111111111111111111111
1000000000110000000000001111111110011111111111111111111
101100000111000000000000111111111011111111
10010000000000000000E000000000000000000001
111111111111111111111111111111111111111111