NO ./Include/assets/walls/Texturelabs_Brick_123S.png
SO ./Include/assets/walls/Texturelabs_Fabric_121S.png
WE ./Include/assets/walls/Texturelabs_Grunge_190S.png
EA ./Include/assets/walls/Texturelabs_Paper_278S.png


F 50,50,50
C 150,150,200


111111111111111111111111111111111111111111111111111111111111
1S000011100000000111000000011100000000111000000011100000001
101110111011101110111011101110111011101110111011101110111101
100010000010000010000010000010000010000010000010000010000001
101011101110111011101110111011101110111011101110111011101101
100000100000010000001000000100000010000001000000100000000001
101110111011101110111011101110111011101110111011101110111101
100010000010000010000010000010000010000010000010000010000001
101011101110111011101110111011101110111011101110111011101101
100000000000010000000000010000000000010000000000010000000001
101110111011101110111011101110111011101110111011101110111101
100010000010000010000010000010000010000010000010000010000001
101011101110111011101110111011101110111011101110111011101101
100000000000010000000000010000000000010000000000010000000001
101110111011101110111011101110111011101110111011101110111101
100000010000000100000010000000100000010000000100000010000001
101110111011101110111011101110111011101110111011101110111101
100000000000000000000000000000000000000000000000000000000001
101110111011101110111011101110111011101110111011101110111101
100000010000010000001000001000000010000010000001000000000001
101111111101111011111011101111011111011101111011111011111101
100000000000010000000000010000000000010000000000010000000001
101110111011101110111011101110111011101110111011101110111101
100010000010000010000010000010000010000010000010000010000001
101011101110111011101110111011101110111011101110111011101101
100000000000000000000000000000000000000000000000000000000001
101110111011101110111011101110111011101110111011101110111101
100010000010000010000010000010000010000010000010000010000001
101011101110111011101110111011101110111011101110111011101101
100000000000010000000000010000000000010000000000010000000001
101110111011101110111011101110111011101110111011101110111101
100000010000000100000010000000100000010000000100000010000001
101111111101111011111011101111011111011101111011111011111101
100000000000010000000000010000000000010000000000010000000001
101110111011101110111011101110111011101110111011101110111101
100010000010000010000010000010000010000010000010000010000001
101011101110111011101110111011101110111011101110111011101101
100000000000000000000000000000000000000000000000000000000001
111111111111111111111111111111111111111111111111111111111111
