NO /home/csalamithome/Desktop/Cub3D/Include/assets/walls/black_wall.png
SO /home/csalamithome/Desktop/Cub3D/Include/assets/walls/grey_wall.png
WE /home/csalamithome/Desktop/Cub3D/Include/assets/walls/simple_black_wall.png
EA /home/csalamithome/Desktop/Cub3D/Include/assets/walls/white_wall.png

F 220,100,0
C 100,10,220

111111111111111
100000001000001
101111001011101
101000000000101
101011111011101
1010N0001000101
101110101110101
101000101000101
100010101011101
101110101000101
101000101110101
100000100000101
111111111111111