NO ./Include/assets/walls/street.png
SO ./Include/assets/walls/obito2.png
WE ./Include/assets/walls/street2.png
EA ./Include/assets/walls/obito4.png


F 50,50,50
C 150,150,200

11111111111111111111
10000000010000000001
10000000010000000001
10000100110000000001
10110000000000000001
10000000001111000001
10000000100000000001
1000001111000000N001
10000000001000000001
11111111111111111111