NO ./Include/assets/walls/street.png
SO ./Include/assets/walls/obito2.png
WE ./Include/assets/walls/whiteWall.png
EA ./Include/assets/walls/pinkWall.png


F 50,50,50
C 150,150,200

11111111111111111111
10000000000000000001
100000000000000W0001
11111111101101111111
11111111101101111111
10000010000000000001
100000100000000W0001
11111111111111111111