NO ./Include/assets/walls/obito.png
SO ./Include/assets/walls/obito2.png
WE ./Include/assets/walls/obito3.png
EA ./Include/assets/walls/obito4.png


F 128,128,128
C 135, 206, 250

111111111111111
100000001000001
101111001011101
101000000000101
101011111011101
101000001000101
101110101110101
101000101000101
100010101011101
101110101000101
101000101110101
1000001S0010101
111111111111111