NO ./Include/assets/walls/obito.png
SO ./Include/assets/walls/obito2.png
WE ./Include/assets/walls/obito3.png
EA ./Include/assets/walls/obito4.png


F 128,128,128
C 0,0,0

111111111111111
100000001000001
101111001011101
101000000000101
101011111011101
1010E0001000101
101110101110101
101000101000101
100010101011101
101110101000101
101000101110101
100000100000101
111111111111111